type octile
height 4
width 6
map1
..@...
..@...
..@...
..@...