type octile
height 9
width 38
map1
.................@....................
.................@....................
.................@....................
.................@....................
.................@....................
.................@....................
.................@....................
.................@....................
......................................